Aller Cavalcanti, Inês	Anna Guim	1r
Amich da Silva, Maria	Ananda	1r
Ardila, Irian	Júlia	1r
Armendia Arráez, Ana	Ananda	1r
Badilla Ortiz, Marianne	Ananda	1r
Bernal Rodas, Juan Pablo	Begonya	1r
Borrazas Gonzalez, Nil	Anna Guim	1r
Botrán Jiménez, Miquel	Júlia	1r
Buil Abadia, Jorge	Ananda	1r
Cano de Alarcón Córdoba, Gala	Ananda	1r
Cantán Ramos, Mia	Begonya	1r
Caron De Araujo, Clara	Anna Guim	1r
Casacuberta Llop, Fatim	Begonya	1r
Chiantore Martínez, Aram	Begonya	1r
Cofreces Romero, Nil	Anna Guim	1r
Colom Sardà, Jana	Ananda	1r
Cuenca Stella, Lluc	Ananda	1r
Cuenca Stella, Muriel	Anna Guim	1r
Cullen Garcia, Alex	Anna Guim	1r
Enciso López, Alejandro	Júlia	1r
Farrés Jarrín, Victòria	Begonya	1r
Farroñan Rodríguez, Sergio Otoniel	Anna Guim	1r
Fernandez Ellis, Elisa	Begonya	1r
Ferrer Vives, Abril	Begonya	1r
Gómez Fernandea, Sofia	Anna Guim	1r
Gudadze, Paata	Júlia	1r
Guzman Menendez, Antú	Júlia	1r
Harks Calvente, Lina	Begonya	1r
Ibañez Maymó, Adrià	Anna Guim	1r
Jede, Xavier	Ananda	1r
Jorge Rubio, Tanit	Anna Guim	1r
Kane Gil, Mariama Fama	Begonya	1r
Laballós Porrà, Abril	Begonya	1r
Laballós Porra, Laia	Júlia	1r
Lario Pinto, Janna	Begonya	1r
Lera Cosme, Eric	Ananda	1r
Li, Noutian	Ananda	1r
Lopera Fernández, Daniel	Begonya	1r
Luis Acosta, Sofia Valentina	Júlia	1r
Martín Barrera, Iris	Anna Guim	1r
Martínez Pardo, Bruno	Anna Guim	1r
Martínez Rodríguez, Ariadna	Júlia	1r
Molinero Hervàs, Ona	Júlia	1r
Mayo d'Alisa, Nicolás 	Begonya	1r
Nureña Solsol, Marco Antonio	Ananda	1r
Oliveira Teixeira, Ignacio Matias	Anna Guim	1r
Osete Cinos, Edith	Júlia	1r
Parra Déu, Biel	Júlia	1r
Peraire Nefedova, Maia	Anna Guim	1r
Perez del Viso, Marcos	Ananda	1r
Pesce Andreatta, Marco	Begonya	1r
Placer Bernués, Lluna	Júlia	1r
Pujol Cardús, Sira	Júlia	1r
Ramirez Peña, Manuel Orlando	Diego	1r
Rios Rosales, Hendry Josue	Begonya	1r
Rull Torrecillas, Roger	Begonya	1r
Ryur, Sofía	Ananda	1r
Silva Aerts, Max	Ananda	1r
Singh, Kamalpreet	Júlia	1r
Sydorova, Viktoria	Anna Guim	1r
Torres Castro, Ariadne Paula	Júlia	1r
Valdivieso Bas, Paola	Ananda	1r
Álvarez Buenaño, Paula	Verena	2n
Amjad, Hibba	Verena	2n
Amlaf Amlaf, Wael	Xavi	2n
Ballester Defior, Joan	Diego	2n
Benmbarka Khamar, Bilal	Verena	2n
Bertrán Bolet, Roc	Fernando	2n
Bondí , Alessio	Diego	2n
Bruga Ortiz, Diego	Verena	2n
Burgués Amorós, Marcel	Xavi	2n
Burguete Gómez, Raúl	Diego	2n
Caballé Redó, Lluna	Verena	2n
Caracuel Pereira, Mar	Diego	2n
Castelló París, Eric	Verena	2n
Chillemi , Tobia	Xavi	2n
Cristià Boullosa, Quim	Xavi	2n
Dalfó Rivas, Gael	Xavi	2n
Dalla Pace, Bruno	Diego	2n
De Moliní, Yago	Verena	2n
El Ouahabi, Rayan	Verena	2n
Gázquez Romeu, Nora	Verena	2n
González Sandoval, Dimas	Verena	2n
Grau Caballero, Èlia	Fernando	2n
Grijalva, Milton	Fernando	2n
Hanse, Nishka 	Diego	2n
Henao Pamplona, Estefanía	Fernando	2n
Lazaga Paglinawan, Cyril	Verena	2n
López Aguado, David	Xavi	2n
Lozano Barranco, Fénitra	Fernando	2n
Martí Prats, Feliu	Diego	2n
Martínez Romans, Wanda	Diego	2n
Marulanda López, Naiara	Fernando	2n
Mondéjar Ortiz, Carlos	Fernando	2n
Oliva García, Guillem	Fernando	2n
Panaite, Maria	Xavi	2n
Parra Deu, Laura Lluna	Xavi	2n
Parvez Kharbach, Malak	Fernando	2n
Peix Lains, Aroa	Diego	2n
Perucchi , Helena	Xavi	2n
Pineda Sauto, Gael	Fernando	2n
Plana Almazán, Elia	Verena	2n
Pujadas Avilés, Jordi	Fernando	2n
Reis Robles, Maya	Diego	2n
Restrepo Castaño, Valeria	Xavi	2n
Richarte Pérez, Antia	Diego	2n
Rodeiro Jennings, Sylvia	Diego	2n
Sánchez Del, Ernest	Xavi	2n
Santanach Casals, Teia	Fernando	2n
Santapau Salvador, Arlet	Fernando	2n
Smatova, Irina 	Xavi	2n
Soldado, Sofia	Xavi	2n
Torrico Tapia, Dani Martin	Diego	2n
Verdaguer Ferrer, Fiona	Verena	2n
Viader Cortés, Arnau	Diego	2n
Aierbe Ydalga, Ander	Teresa	3r
Alcoba Torres, Tais	Jose	3r
Amat Fernández, Gael	Dídac	3r
Anguita Vizcaino, Marc	Noemí	3r
Astigarraga Guitart, Max	Dídac	3r
Bayle García, Paul	Jose	3r
Bhandari, Rojina 	Noemí	3r
Boronat Molina, Eric	Dídac	3r
Boronat Villafaña, Milena	Jose	3r
Braghis Leahu, Beatriz	Dídac	3r
Broeken Tinkler, Rafael	Noemí	3r
Calvo Moreno, Gabriel 	Elena.S	3r
Clémençon Uriel, Lia	Noemí	3r
Compte Torrón, Roger	Teresa	3r
Cuevas Vazquez, Alvaro	Jose	3r
d'Alisa , Claudia Pilar	Elena.S	3r
Daniel Flores, Marc	Gemma	3r
Díaz Rivera, Alan	Jose	3r
Egaña Beza, Alai	Gemma	3r
El Arroudi El Issaoui, Redwan	Elena.S	3r
Ferrer Vives, Julia	Gemma	3r
Fontdeglòria Vinyes, Niraj	Elena.S	3r
Francioni Diéguez, Dante	Gemma	3r
Gómez Navales, Pau	Elena.S	3r
Goodwin Bamballi, Teo	Jose	3r
Guardiola Rosendo, Naia	Gemma	3r
Haddad Maache, Adam	Jose	3r
Harks Calvente, Sonia	Jose	3r
Houman El Ghrissat, Ayoub	Noemí	3r
Ibáñez Maimó, Aina	Noemí	3r
Iborra Bravo, Aitor	Jose	3r
Jin , Shan Shan	Dídac	3r
Jin , Hu	Noemí	3r
Kostic , Milos	Dídac	3r
Kouimen Abouchaib, Aisha	Jose	3r
Kravchyk Stupak, Maksym	Jose	3r
Kurelovic Parera, Ian	Teresa	3r
Lázaro Barraza, Unai	Gemma	3r
Linuesa Garcia, Biel	Elena.S	3r
Liuboshevska , Anastasiia	Noemí	3r
Londoño Herrera, Estefani	Teresa	3r
López Aguado, Raúl	Dídac	3r
Luque Righi, Enea	Elena.S	3r
Mariño Peñafiel, Noah	Elena.S	3r
Martinez Moya, Zambra	Gemma	3r
Maure Rubé, Bruno	Teresa	3r
Mboukem Monsuy, Anaïs	Dídac	3r
Mboukem Monsuy, Jade	Elena.S	3r
Miras Saturio, Júlia	Teresa	3r
Mora Krtolica, Novak	Dídac	3r
Nieto Machado, Ariadna	Elena.S	3r
Oriol Sardà, Joana	Dídac	3r
Petrovicheva, Julia 	Noemí	3r
Pimentel Díaz, Artur	Dídac	3r
Pintado Reyes, Claudia	Elena.S	3r
Pons Otero, Sasha	Gemma	3r
Puerto Moreno, Lola	Gemma	3r
Quiñonero Sánchez, Laia	Jose	3r
Ramos Silva, Zaira	Teresa	3r
Raventós Barracó, Pau	Gemma	3r
Reece Mogollón, Andrea	Noemí	3r
Reyes Brugnoli, Teo	Noemí	3r
Rigo Rofes, Mar	Gemma	3r
Ripoll Abadia, Candela	Teresa	3r
Rivera Andrade, Daniel	Teresa	3r
Rodríguez Hechavarria, Mònica	Dídac	3r
Rosas Garzón, David	Jose	3r
Schardosim Mejía, Isaac	Elena.S	3r
Sebastian Escorihuela, Martina	Teresa	3r
Serrano Maroquin, Allison	Dídac	3r
Silveira Corbellini, Martin	Dídac	3r
Simoncini Gómez, Lila	Teresa	3r
Spucches , Lucas	Teresa	3r
Sunyer Porta, Caterina	Noemí	3r
Tarrés Cantos, Alèxia	Teresa	3r
Thomas Opris, Teo	Gemma	3r
Torres Martín, Bruno	Dídac	3r
Valle Hernández, Josep	Elena.S	3r
Van Hoorn Alpañes, Rita	Teresa	3r
Villanueva Quispe, Derek	Noemí	3r
Villanueva, Georgy	Gemma	3r
Villanueva, Vladimir	Noemí	3r
Viralta Miñana, Gerard	Jose	3r
Aissaouy Chinek, El Mahdi	Ferran	4t
Armengol Tarragó, Guim	Joel	4t
Armengol Tarragó, Maia	Jordi	4t
Assou Ocaña, Salma	Iolanda	4t
Badilla Ortiz, Luciana	Joel	4t
Balsa Bogao, Juan	Jordi	4t
Biarnés Ruiz, Jan	Enric	4t
Bica Abuliak, Milo	Serena	4t
Blancafort Mengual, Anna	Enric	4t
Bou, Aina	Jordi	4t
Cano Escudero, Javier	Serena	4t
Casacuberta Llop, Keita	Ferran	4t
Castelló Paris, Teo	Serena	4t
de Cambra Barba, Simón	Joel	4t
El Arroudi Elissaoui, Kawthar	Jordi	4t
Errami , Zacaria	Serena	4t
Escalona Heras, Pablo	Joel	4t
Español Lozano, Biel	Joel	4t
Fabregas Turati, Pol	Joel	4t
Fernández Ellis, Aleix	Jordi	4t
Fernández Heredia, Jorge	Ferran	4t
Furriols Cavaller, Alba	Iolanda	4t
Gabaldón Rivera, Joan	Enric	4t
García Freile, Cloe	Jordi	4t
Ghiglino Valencia, Iker	Serena	4t
Gomez Fernandez, Nicolas	Enric	4t
Guzmán Menéndez, Tahiel	Serena	4t
Hernandez Melendez, Sergio	Ferran	4t
Jiménez Riera, Ixam	Serena	4t
Kuzurbardov, Violeta	Jordi	4t
Medina Angulo, Kimiko	Enric	4t
Mejía Ramírez, Andrés	Iolanda	4t
Moré Abad, Amanda	Serena	4t
Moya Salvador, Manuel	Joel	4t
Nierga Franch, Emma	Ferran	4t
Notivoli Seuma, Daniela	Serena	4t
Oliveira Teixeira, Diego	Iolanda	4t
Orejuela Espinel, Neola	Enric	4t
Panaite, Nicolas	Ferran	4t
Patta Melo, Iván	Ferran	4t
Peraire Nefedova, Alina	Jordi	4t
Pla Bayó, Èlia	Jordi	4t
Pozas Durany, Júlia	Ferran	4t
Ribot Carlos, Ivana	Joel	4t
Rodrigo Alcántara, Carla	Enric	4t
Rojas Zarco, Alba	Jordi	4t
Rull Torrecillas, Rita	Jordi	4t
Sabio Valls, Roc	Enric	4t
Sáez Poch, Juan Carlos	Joel	4t
Sahar, Noor	Ferran	4t
Sanoja Álvarez, Luciana	Serena	4t
Sellarès Gómez, Biel	Iolanda	4t
Serrano Fernández, Cristina	Iolanda	4t
Silva Aerts, Sam	Iolanda	4t
Tavira Podesta, Valentín	Iolanda	4t
Tayleur Rodríguez, Victor	Joel	4t
Temes Alés, Marc	Iolanda	4t
Toledo Cornellà, Guiu	Joel	4t
Vázquez Porta, Gal·la	Enric	4t
Velarde Velázquez, Ivonne	Enric	4t